1,1,1,1,1,1,1,1,1,1,1,1,1,1,1,1,1
2,0,0,0,2,0,2,0,2,0,0,0,2,0,0,0,2
3,1,1,1,3,0,2,0,3,1,1,1,3,1,1,1,3
0,0,2,0,3,1,3,1,3,0,2,0,2,0,0,0,2
1,1,3,1,3,0,0,0,2,0,2,0,3,1,1,1,3
2,0,2,0,3,1,1,1,3,1,3,1,3,0,2,0,0
2,0,2,0,2,0,0,0,2,0,0,0,3,1,3,1,1
3,1,3,1,3,1,1,1,3,1,1,1,3,0,2,0,2
2,0,0,0,2,0,0,0,2,0,0,0,2,0,2,0,2
3,1,1,1,3,1,1,1,3,1,1,1,3,1,3,1,3
0,0,0,0,0,0,0,0,0,0,0,0,0,0,0,0,0
0,0,0,0,0,0,0,0,0,0,0,0,0,0,0,0,0
0,0,0,0,0,0,0,0,0,0,0,0,0,0,0,0,0
